L1
R10
C10
X9
Y6
M0010000000
0011100000
0000100000
1000100000
0000100000
0011100000
0010001110
0010001010
0001111100
0000001000

L2
R10
C10
X9
Y6
M0010001000
0010111000
0000100000
1000100000
0000100000
0011100000
0010001110
0011001010
0001111100
0000001000